###################################################
#.........#...##..#............#..................#
#.......~............~.......~...............#....#
#...................#..........#....#....##......##
#....#.#................#...........~....#.......##
#.............#....#.#.......#.......#..........~.#
#...........#.............#..~....................#
#...#...:.~......#.#.............#.....#.....#...##
#................#..#........:.#...:..#...~.:...#.#
#....................#.........................#.##
#............#..#........##.........:#..........#.#
#...#....#.......#.............#..................#
#............#.....................#........#.....#
#.~#.................~....~......:..........:.....#
#..........:..:.::.............#..............#...#
##.........:...#....#..#.#....#..#.....#..........#
#.#........................:....#....~....~.#~#...#
##..#.....................................#...#...#
###.......#...:.....~..............#.#.#..........#
#....:...#................:........:.........#....#
#..#.~.......#................#.........#..:......#
#...:.............~#.......##.........:..........##
#...~...#..#.##.#....#.............#......#.......#
#........:.#..##.....:..#.............:.....#.....#
#..#..#...:......#........:#.~....................#
#~.......#.....#~#.......@...:...........~........#
#...................#...:.....:.....#.....#.#..#..#
#...#.............#......#......................#.#
#.....#~......##.........................#........#
#....#....#.....................~:...#..~....#..#.#
#..#......#............#........#..#.~...........~#
#.........:......#.............~....#.............#
##~...:.........:#...#..#....:...............#....#
#...#..:.#..:.......~#................#~.........##
#...:...#..#....#..#..............:#..#...........#
#.....................~.:......#...~#....#........#
#.#.....~............#.................~..:.......#
##..........................:.......#.....#.......#
#............##.....#..#......#.........#........:#
#..#:..~....#.........#...~..#.#........#...~.....#
#.........:........#......:......:.........#...#.~#
#...............:......:...........~.....#..#.....#
#...~...#....................................#...:#
#..#:.................#...........................#
#....#...#................#.#.:........#.....#....#
#...~.......~......#........~....#~...............#
#.~....~.................:.........#...........#..#
#.........##.......#.............................##
###..#:................##....#.....#...#..........#
#.........#............~#..#......##:....:........#
###################################################
