#####################################################
#......:...................~......#.....#...##......#
#.#......#....#..........~..............#~.......#..#
#...........#...........#.........................:.#
#.....##.....#........#..##.#..#..................###
#..#...#...#..........#.........#....~.~..#.........#
#...:.##....#....#...#..~.........:....#.#..........#
#...#.....#..#.....#........:.....#...............#.#
#.................#..........#....................#.#
#....................#....#.............#...........#
#..#...#...:.......................:.#....##........#
#........#...#..#:..........#...................#...#
#............................#.....:##:...#.#......##
#:..~...........................:......#....#......##
#....:...#...........#.:.....~.#....................#
#.....#....:..#....:......#.....#:......#.....#.....#
#....................##......##.#.....~..#..#.#...#.#
#.....#..........~.........##....#...##..........##.#
#.#......#...........#..........##..................#
#..............#........#...........#...............#
#.....###....#...~......#......:..##.#..............#
#..#.....:.............#...#.............#....:.....#
#..............#.:..#..#..~:....:.............:.#...#
#...................#.......................#.......#
#..........#.............................#..........#
#.............#...................#..#..:~.......:..#
#......:..#....#..##......@#...............#........#
#.#...##...#............##......#....#....#.........#
#.##...#.............~.##.~......#.#.........#......#
#........#............#......#........~..#.....##.#.#
#.#.#..........#........~.................:...#.:.#.#
#...........#.................................#.....#
#......#..:..................#.............~~.......#
#.................~......:.....#..#.....:...........#
#.....#...#........#......:.#.............:......:..#
#.......:#.........#..........:.~...#..~.#...#....#.#
#................................##..............#..#
#............#.....~..........#.......#...........#.#
#~#.........#..#...#.........##...........#....:.#..#
#...................:......##..........#............#
#...............#.....#............#........~.#:....#
#.........#...#.........#...:..#..#.....#.#......#..#
#.....##....#...............#..#..........~..##.....#
#..............#.........#..................#....##.#
#..................:#.#........................#....#
#..........#.........................#........###:..#
#..........#..:........##......#...........#.......##
#.......::.....................##~#.....~...........#
#:.......:.....##...........#......~...........#....#
#............~.:...#.#:.....................#.....#.#
##..#...#...#.......................................#
#........#..#...##.#...............:.......#........#
#####################################################
